1111111111
1111111111
1111000211
1111011111
1000004111
1111011111
1111011111
1111011111
1111911111
1111111111