901200000001
001110101101
001011111100
001011111101
100000000100
110000000101
110111111101
110000000001