11111
14401
10111
10021
19111
11111
